##########
#........F
#.########
#.########
#.########
#.########
#.########
#.########
#.########
#S########