#####F#####
#.....#...#
##.####.###
#.........#
###.#####.#
#.###...#.#
#.#...#...#
#...#.#.#.#
#####S#####